21
.ooo..o..o.o.o..o.oo.o........o.oo.o....o.....o...o...oo..o..ooo........o....o........o.o.o...ooo
...........o...o.o.oo...........o...o.o...oo.o..o..o...o...ooo....oo..ooo......o...............o.
o............o.....oo..ooo.o..o..o....o....o.oo.......oo.....oo.......o.......o..o.ooo.oo........
......oo..oo....o..oo........oo.oo..o.......o..........o......o...o..oo........o..o....o.....o.o.
oo...o.o...oo.o..o.....ooo.o................o..o....ooo.o.o.o....ooooo.o.....o.....o......o..ooo.
..o...o..o..oooo......oo........o.oo....o...o...o..oo..o.o...........o....o......o....oo.o.ooo...
....oo..o...o.o.o.o.o.o........o.o.o..o.oo..o..o.oo......o.o....o.....o.oo.o..o.....o..o.o...o...
..ooo...oo...o..oo....o....oo.oo...o....oo..........ooo................ooo......o..ooo...........
..oo.............o..................ooo..o....o.o....o......o.o.......o......oo.........o.o......
...o.....ooo.o.........ooooo.o...oo..........o..o.....o.ooo..o.........o..oo.......o...ooo..o.oo.
.....o...o..o..o...........o..oo..o.....o.oo.oo..oo................o.....ooo..o......o.....oo..o.
oooo...o............o..oo............oo...oo.....o...o....o.o.o.o.....o.o..oo..................oo
.......oo..o...oo..........o...o....ooo....o..oo...o...o...oo.......oo.oo..............o.....o.o.
.oo.oo....oooo.....o.....o.o.o......o.o....o.....o........o....o.............oo...ooo.......oo..o
...o.o.......oo..o.....o.....o.o...o.oo.......o.o...ooo..........o.o..o...oo.......o.............
.....o...o.oo..o.....o...o..o...oo....oo.o......o..o.....o.oo...o.oo......oo...o...oo...oo.......
..o..oo.....o.o..o..ooo.o....o.o..o......o.....o.oo.......o.o..o..o.o.o...oo......o.......o..oo..
.o.....o...o.oo...oo.o..o....o..o...o......o.....ooo...o....o...........ooo...o....oo..o.......o.
..o....oo..o.o.....o.o..o.o...oo......o...o..o....o.............o..oo..............o....o..o....o
oo......o....o.o...oo...oo.o.......o..o.o...............o..oooo..o.o.......oo..oo..........o...o.
.oo..o.o...oo.......o.o..o.o..o..o...oo..o.oo......o....oo......oo.o.o.........o...oo.o.o.o......
